"Player","Age","Team","Pos","GP","G","A","PTS"
Leon Draisaitl,29,EDM,C,43,31,33,64
Sam Reinhart,29,FLA,C,44,27,24,51
Mikko Rantanen,28,COL,RW,44,25,35,60
Mark Scheifele,31,WPG,C,44,25,25,50
Brayden Point,28,TBL,C,37,25,22,47
William Nylander,28,TOR,C,44,24,20,44
Kyle Connor,28,WPG,LW,44,23,32,55
Kirill Kaprizov,27,MIN,LW,34,23,27,50
Cole Caufield,24,MTL,RW,42,23,17,40
Rickard Rakell,31,PIT,RW,45,22,16,38
