"Player","Age","Team","Pos","GP","G","A","PTS"
Nathan MacKinnon,29,COL,C,44,15,53,68
Mitch Marner,27,TOR,RW,44,14,45,59
Jack Eichel,28,VEG,C,42,11,43,54
Nikita Kucherov,31,TBL,RW,39,20,42,62
Connor McDavid,28,EDM,C,40,17,42,59
Quinn Hughes,25,VAN,D,38,9,38,47
Jesper Bratt,26,NJD,W,45,15,36,51
Cale Makar,26,COL,D,44,13,36,49
Sidney Crosby,37,PIT,C,45,12,36,48
Mikko Rantanen,28,COL,RW,44,25,35,60
